border_size=1
usage=map

_off^_usr, _off^_usr, _off^_usr, Ss, Ss, Ss, Ss, Ss, Ss, Ss, Ss, Hh, Hh, Gg, Gg, Gg, Hh, Hh, Gg, Gg, Gg, Gg, Gll^Fp, Gg, Gll^Fp, Gg, Gg, Gg, Gll^Fp, Gll^Fp, Gg, Gg, Gll^Fp, Gll^Fp, Gll^Fp, Mm, Mm, Mm, Mm, Mm, Md, Dd, Dd, _off^_usr, _off^_usr, _off^_usr
_off^_usr, _off^_usr, Ss, Gll^Fp, Ss, Ss, Ss, Ss, Ss, Ss, Ss, Hh, Gg, Gll^Fp, Gll^Fp, Gg, Gll^Fp, Hh, Gll^Fp, Gg, Gg, Gg, Gg, Gll^Fp, Gg, Gg, Gll^Fp, Gg, Gg, Gg, Gg, Gg, Gg, Gg, Gg, Gll^Fp, Mm, Mm, Mm, Mm, Md, Dd, Dd, Dd, Dd^Do, _off^_usr
Ww, Ss, Ss, Ww, Gll^Fp, Gll^Fp, Ss, Ss, Ss, Ss, Gll^Fp, Gg, Gg, Gg, Gg, Gg, Gg, Hh, Gg, Gg, Gg, Gg, Gg, Gg, Gg, Gg, Gll^Fp, Gll^Fp, Gg, Gll^Fp, Gg, Gll^Fp, Gll^Fp, Hh, Hh, Mm, Mm, Mm, Md, Md, Hd, Dd, Dd, Dd, Dd, Dd
Ww, Ww, Ss, Ss, Ss, Ss, Ss, Ss, Hh, Gll^Fp, Gg, Hh, Gg, Gg, Gg, Hh, Gg, Gg, Gg, Gg, Gg, Gll^Fp, Gll^Fp, Gg, Gg, Gll^Fp, Gll^Fp, Gg, Gg, Gg, Gg, Gg, Gg, Gg, Hh, Hh, Mm, Mm, Md, Hd, Dd, Dd, Dd, Dd, Dd, Dd
Ww, Ww, Ss, Ss, Ss, Ss, Ss, Ss, Hh, Gll^Fp, Gg, Gg, Gll^Fp, Gg, Gg, Gll^Fp, Hh, Gg, Gll^Fp, Gg, Gg, Gll^Fp, Gll^Fp, Gll^Fp, Gg, Gg, Gg, Gg, Gll^Fp, Gg, Gll^Fp, Gll^Fp, Gg, Gg, Gg, Hh, Hh^Vhh, Mm, Hd, Hd, Hd, Dd, Dd, Dd, Dd, Dd
Ww, Ww, Ww, Ss, Ww, Ss, Ss, Hh, Gg, Gll^Fp, Gg, Gg, Gg, Gg, Gg, Gg, Gg, Gg, Gg, Gg, Gg, Gg, Gll^Fp, Gg, Gg, Hh, Gg, Gg, Gg, Gll^Fp, Gg, Gg, Gg, Gll^Fp, Gg, Hh, Hh, Mm, Mm, Dd, Dd, Dd, Dd, Dd, Dd, Dd
Ww, Ww, Ww, Ss, Ww, Ww, Ss, Hh, Hh, Gg, Gg, Gll^Fp, Gg, Gg, Gg, Gll^Fp, Gg, Gg, Gg, Gg, Gg, Gg, Gg, Gg, Gg, Gg, Gg, Gg, Gg, Gg, Gg, Gg, Gg, Gg, Gg, Gg, Gg, Mm, Hd, Hd, Dd, Dd, Dd, Dd, Dd, Dd
Ww, Ww, Ww, Ww, Ss, Ss, Ss, Ss, Gg, Gg, Gg, Gg, Gg, Gg, Gg, Gg, Gg, Gg, Hh, Gg, Gg, Gg, Gg, Gg, Hh, Gg, Gg, Gg, Gg, Gg, Gg, Gg, Gll^Fp, Gll^Fp, Gg, Hh, Gg, Gg, Dd, Mm, Dd, Dd, Dd, Dd, Dd, Dd
Ww, Ww, Ww, Ww, Ww, Ww, Ss, Ss, Gg, Gg, Gg, Gg, Gg, Gg, Gg, Gg, Gg, Gs^Vh, Gg, Gg, Gg, Gg, Gg, Hh, Gg, Gg, Gll^Fp, Gll^Fp, Gll^Fp, Gg, Gg, Gg, Gg, Gg, Gg, Hh, Mm, Hd, Dd, Dd, Dd, Dd, Dd, Dd, Dd, Dd
Ww, Ww, Ww, Ww, Ww^Vm, Wwf, Wwf, Gg, Gg, Gg, Gg, Gs^Fds, Gg, Gg, Hh, Gg, Gg, Gg, Gg, Gg, Gg, Gg, Gg, Gg, Gg, Gg, Gg, Gg^Ve, Gg, Gg, Gll^Fp, Gg, Gg, Gg, Hh, Hh^Vhh, Hh, Hd, Gg, Mm, Dd, Gg, Dd, Dd, Dd, Dd
Ww, Ww, Ww, Ww, Ww, Ww, Wwf, Gs^Vc, Gg, Gg, Gg, Gs^Fds, Gg, Gs^Fds, Gg, Gg, Gs^Vh, Gg, Gg, Gg, Hh, Gg, Gg, Gg, Gg, Gg, Gg, Gg, Gg, Gg, Gg, Gg, Gg, Gg, Hh, Hh, Gg, Gg, Gg, Gg, Dd, Dd, Dd, Dd, Dd, Dd
Ww, Ww, Ww, Ww, Ww, Ww, Ww, Wwf, Ww, Gg, Gg, Gg, Gg, Gg, Gg, Gg, Gg, Gg, Gg, Gg, Gg, Gg, Gg, Gg, Gg, Gll^Fp, Gg, Gg, Gg, Gll^Fp, Gg, Gg, Gs^Vh, Gg, Gg, Mm, Gg, Gg, Dd, Dd, Dd, Dd, Dd, Dd, Dd, Dd
Ww, Ww, Ww, Ww, Ww, Ww, Wwf, Wwf, Ww, Gg, Gg, Gg, Gg, Gg, Gg, Gg, Gg, Gg, Gg, Gg, Gg, Gg, Gg, Gll^Fp, Gg, Gg, Gg, Gg, Gg, Gll^Fp, Gg, Gg, Gg, Gg, Gg, Gg, Gg, Dd, Dd, Dd^Vdt, Dd, Dd, Dd, Dd, Dd, Dd
Ww, Ww, Ww, Ww, Gs^Vc, Wwf, Gg, Ww, Ww, Wwf, Ww, Ww, Ww, Gs^Fds, Ww, Gg, Gg, Gg, Gg, Gg, Gg, Gg, Gg, Gg, Gg, Gg, Hh, Gg, Gg, Gg, Gg, Hh, Hh, Hh, Gg, Gg, Gg, Gg, Dd, Dd, Dd, Dd^Do, Dd, Dd, Dd, Dd
Ww, Ww, Ww, Ww, Gg, Gg, Gg, Gs^Vc, Gg, Gg, Gg, Ww, Gg, Ww, Gg, Wwf, Ww, Gg, Gg, Gg, Gg, Gg, Gg, Gg, Gg, Hh, Hh^Vhh, Hh, Gg, Gll^Fp, Hh, Mm, Gg, Gg, Gg, Gg, Gg, Gg, Dd, Dd, Dd, Dd, Dd^Vdt, Dd, Dd, Dd
Ww, Ww, Ww, Ww, Gg, Gg, Gg, Gg, Hh, Gg, Gg, Gg, Gs^Fds, Gg, Gg, Gg, Ww, Ww, Ww, Gg, Gg, Gg, Gg, Gg, Gg, Gg, Gg, Gg, Gg, Gg, Gg, Gg, Gg, Gg, Gg, Gg, Gg, Gg, Dd, Dd, Dd, Dd, Dd, Dd, Dd, Dd
Ww, Ww, Ww, Ww, Gg, Gg, Gg, Gg, Gg, Gg, Hh, Gg, Gs^Fds, Gs^Fds, Gg, Gg, Gg, Gs^Vc, Ww, Gg, Gg, Gg, Gg, Hh, Gg, Gg, Ch, Gg, Ch, Gg, Gg, Gll^Fp, Gg, Gg, Gg, Gg, Gg, Gg, Dd, Dd, Dd, Dd, Dd, Dd, Dd, Dd
Ww, Ww, Ww, Ww, Gg, Gg, Gg, Gg, Gg, Gg, Gg, Gg, Gg, Gg, Gg, Gg, Gg, Ww, Ww, Gg, Gg, Gs^Vh, Gg, Gg, Ch, Ch, Hh, Ch, Gs^Vh, Ch, Gg, Gg, Gg, Gg, Gg, Gg, Gg, Gg, Gg, Dd, Dd, Dd, Dd, Dd, Dd^Do, Dd
Ww, Ww, Ww, Ww, Gg, Gg, Gg, Gg, Gg, Gg, Gg, Hh, Hh, Gg, Gg, Gg, Gg, Gg, Wwf, Gg, Gg, Gg, Chr, Chr, Gg, Kh, Gg, Gg, Gg, Gg, Gg, Gg, Gg, Gg, Gg, Gg, Gg, Gg, Dd, Dd, Dd, Dd, Dd, Dd, Dd, Dd
Ww, Ww, Ww, Ww, Ww, Gg, Gg, Gg, Gg, Gg, Gs^Fds, Hh, Hh^Vhh, Gg, Gg, Gg, Gg, Gg, Gg, Wwf, Wwf, Gg, Gg, Gg, Gg, Gg, Gg, Gg, Gg, Hh, Gg, Gg, Gll^Fp, Gg, Gg, Gg, Gg, Dd, Dd, Dd, Dd, Dd, Dd, Dd, Dd, Dd
Ww, Ww, Ww, Ww, Ww, Ww, Gg, Gs^Vc, Gg, Gg, Gg, Gs^Fds, Gg, Gg, Gg, Gg, Gg, Gg, Gg, Gg, Gg, Ww, Ww, Gg, Gg, Gg, Gll^Fp, Gg, Gg, Gg, Gg, Gg, Gg^Ve, Gg, Gg, Gg, Gg, Gg, Gg, Gg, Gg, Gg, Dd, Dd, Dd, Dd
Ww, Ww, Ww, Ww, Ww, Ww, Ww, Gg, Gg, Gs^Fds, Gg, Gg, Gg, Gg, Gg, Gg, Gg, Gg, Gg, Gg, Gg, Ww, Ww, Gg, Gg, Gg, Gg, Gll^Fp, Gg, Gg, Gg, Gg, Gg, Gg, Gg, Gg, Gg, Gg, Gg, Gg, Gg, Gg, Dd, Dd, Dd, Dd
Mm^Xm, Ww, Ww, Ww, Ww, Ww, Ww, Gg, Gg, Gs^Fds, Gg, Gg, Gg, Hh, Gg, Gg, Gg, Gg, Gg, Gg, Gg, Ww, Gs^Vh, Gg, Gg, Gg, Gg, Gg, Gll^Fp, Gg, Hh, Gg, Gg, Gg, Gg, Gg, Gll^Fp, Gll^Fp, Gll^Fp, Gg, Gg, Dd, Dd, Dd, Dd, Dd
Mm^Xm, Mm^Xm, Ww, Ww, Ww, Ww, Ww, Gs^Fds, Gs^Fds, Gg, Gg, Gg, Gg, Gg, Ce, Hh, Hh, Gg, Gg, Gg, Gg, Ww, Ww, Gg, Gg, Gg, Gg, Gg, Gg, Gg, Gg, Gll^Fp, Gg, Gg, Gg, Gg, Gg^Ve, Gll^Fp, Dd, Dd, Gg, Dd, Gg, Dd, Dd, Dd
Mm^Xm, Mm^Xm, Ww, Ww, Ww, Ww, Ww, Gs^Fds, Gs^Fds, Gg, Gg, Gg, Gg, Gg, Ce, Hh, Gg, Gg, Gg, Gg, Gg, Ww, Ww, Gg, Gg, Gg, Gg, Gg, Gg, Gg, Gll^Fp, Gll^Fp, Gg, Gg, Gg, Gg, Gg, Gll^Fp, Dd, Dd, Gg, Gg, Gg, Gg, Gg, Dd
Mm^Xm, Mm^Xm, Ww, Ww, Ww, Ww, Ww, Gs^Fds, Gs^Fds, Gs^Fds, Gg, Gg, Gg, Ce, Ce, Ke, Gg, Gg, Hh, Gg, Gg, Ww, Ww, Ww, Ww, Ww^Bw|, Ww^Bw|, Gg, Gg, Gg, Gll^Fp, Gll^Fp, Gll^Fp, Gg, Gg, Gg, Gg, Gg, Gg, Gg, Gll^Fp, Gg, Gg, Gg, Gg, Dd
Mm^Xm, Mm^Xm, Mm^Xm, Ww, Ww, Ww, Ww, Ww, Ww, Ww, Gg, Gs^Vc, Gg, Gg, Gg, Gg, Gg, Gg, Gg, Gg, Gg, Gg, Gg, Ww, Ww, Ww^Bw|, Ww^Bw|, Ww^Bw|, Ww, Gg, Gg, Gll^Fp, Gll^Fp, Gg, Gg, Gg, Gg, Gg, Gg, Gg, Gg, Gll^Fp, Gg, Gg, Gll^Fp, Gg
Mm^Xm, Mm^Xm, Mm^Xm, Mm^Xm, Mm^Xm, Ww, Ww, Ww, Ww, Ww, Ww, Gg, Gg, Gg, Gg, Gg, Gg, Gg, Gg, Gg, Gg, Gg, Gg, Gg, Ch, Ww^Bw|, Gg, Ww^Bw|, Ch, Ww, Ww, Gll^Fp, Gll^Fp, Gg, Gg, Dd, Gg, Gg, Gg, Gg, Cv, Gg, Gg, Gg, Gll^Fp, Gll^Fp
Mm^Xm, Mm^Xm, Mm^Xm, Mm^Xm, Mm^Xm, Ww, Ww, Ww, Ww, Ww, Ww, Ww, Ww, Ww, Ww, Gg, Ww, Gg, Gg, Gg, Gg, Gg, Ch, Ch, Ch, Gg, Gg, Gg, Ch, Ch, Ch, Ww, Ww, Gll^Fp, Gg, Gg, Gg, Gg, Gg, Dd, Gg, Cv, Gg, Gg, Gll^Fp, Gg
Mm^Xm, Mm^Xm, Mm^Xm, Mm^Xm, Mm^Xm, Mm^Xm, Ww, Ww, Ww, Ww, Ww, Ww, Ww, Ww, Wwr, Ww, Ww, Ww, Ww, Ww, Chw, Chw, Ww, Gg, 2 Khw, Gg, Rr^Vhc, Gg, 3 Kh, Gg, Gg, Ch, Ch, Ww, Ww, Gg, Dd, Dd, Gg, Gg, Cv, Kv, Gg, Gg, Gg, Gg
Mm^Xm, Mm^Xm, Mm^Xm, Mm^Xm, Mm^Xm, Mm^Xm, Mm^Xm, Ww, Ww, Ww, Ww, Wwr, Wwr, Ww^Vm, Wwr, Wwr, Wwr, Wwr, Ch, Chw, Gg, Ww, Gg, Ww, Gg, Gg, Gg, Gg, Gg, Gg, Gg, Gg, Gg, Ch, Ch, Ww, Ww, Gg, Gg, Gll^Fp, Cv, Cv, Gll^Fp, Gg, Gg, Gg
Mm^Xm, Mm^Xm, Mm^Xm, Mm^Xm, Mm^Xm, Mm^Xm, Mm^Xm, Mm^Xm, Mm^Xm, Ww, Mm^Xm, Ww, Ww, Ww, Ww, Ww, Wwr, Wwr, Ch, Gg, Gg, Gg, Rr^Vhc, Gg, Gg, Gg, Gg, Ww, Ww, Gg, Rr^Vhc, Ww, Ww, Ww, Ch, Ww, Ww, Gg, Gg, Gg, Gll^Fp, Gll^Fp, Gg, Gll^Fp, Gg, Gg
Mm^Xm, Mm^Xm, 5 Mm^Xm, Mm^Xm, Mm^Xm, Mm^Xm, Mm^Xm, Mm^Xm, Mm^Xm, Mm^Xm, Mm^Xm, Mm^Xm, Mm^Xm, Ww, Ww, Ww, Ww, Wwr, Ch, Ch, Ch, Gg, 1 Kh, Gg, Gg, Gg, Gg, Gg, Gg, Gg, 4 Kh, Gg, Ch, Ch, Ch, Ww, Ww, Ww, Ww, Gg, Gg, Gg, Gll^Fp, Gll^Fp, Mm^Xm, Mm^Xm
Mm^Xm, Mm^Xm, Mm^Xm, Mm^Xm, Mm^Xm, Mm^Xm, Mm^Xm, Mm^Xm, Mm^Xm, Mm^Xm, Mm^Xm, Mm^Xm, Mm^Xm, Ww, Ww, Ww, Ww, Wwr, Ch, Gg, Gg, Ch, Gg, Gg, Gg, Gg, Rr^Vhc, Gg, Gg, Gg, Gg, Ch, Gg, Gg, Ch, Ww, Ww, Ww, Ww, Ww, Mm^Xm, Gg, Mm^Xm, Mm^Xm, Mm^Xm, Mm^Xm
Mm^Xm, Mm^Xm, Mm^Xm, Mm^Xm, Mm^Xm, Mm^Xm, Mm^Xm, Mm^Xm, Mm^Xm, Mm^Xm, Mm^Xm, Mm^Xm, Mm^Xm, Mm^Xm, Ww, Ww, Ww, Ww, Gg, Gg, Gg, Gg, Gg, Gg, Gg, Gg, Gg, Gg, Gg, Gg, Gg, Gg, Gg, Gg, Gg, Ww, Ww, Ww, Gg, Mm^Xm, Mm^Xm, Mm^Xm, Mm^Xm, Mm^Xm, Mm^Xm, Mm^Xm
